####################################
#                ##                #
#                ##                #
#  ####  ######  ##  ######  ####  #
#  ####  ######  ##  ######  ####  #
#  ####  ######  ##  ######  ####  #
#  ####  ######  ##  ######  ####  #
#                                  #
#                                  #
#  ####  ##  ##########  ##  ####  #
#  ####  ##  ##########  ##  ####  #
#        ##      ##      ##        #
#        ##      ##      ##        #
#######  ######  ##  ######  #######
#######  ######  ##  ######  #######
#######  ##              ##  #######
#######  ##              ##  #######
#######  ##              ##  #######
#######  ##  ##########  ##  #######
    S        ##########             
#######  ##  ##########  ##  #######
#######  ##              ##  #######
#######  ##              ##  #######
#######  ##              ##  #######
#######  ##  ##########  ##  #######
#                ##            *   #
#                ##                #
#  ####  ######  ##  ######  ####  #
#  ####  ######  ##  ######  ####  #
#    ##                      ##    #
#    ##                      ##    #
###  ##  ##  ##########  ##  ##  ###
###  ##  ##  ##########  ##  ##  ###
#        ##      ##      ##        #
#        ##      ##      ##        #
#  ############  ##  ############  #
#  ############  ##  ############  #
#                                  #
#                                  #
####################################
