###################
#        #        #
# ## ### # ### ## #
# ## ### # ### ## #
#                 #
# ## # ##### # ## #
#    #   #   #    #
#### ### # ### ####
#### #       # ####
#### #       # ####
    S  #####       
#### #       # ####
#### #       # ####
#### # ##### # ####
#        #    *   #
# ## ### # ### ## #
#  #           #  #
## # # ##### # # ##
#    #   #   #    #
# ###### # ###### #
#                 #
###################
